...###
..##.#.####
.##..###..#
##....&...#
#&..@..#..#
###..###..#
..#..#....#
.##.##.#.##
.#......##
.#.....##
.#######