   .###
  ##&#.####
 ##.+###.&#
##.h..&...#
#&.v@..#&.#
###..###..#
..#+.#...&#
.##.##&#.##
.#&.....##
.#.+.&.##
.#######