##########################
###########################
##.......................##
####..........#..........##
######..........#........##
#######..................####
####################....###
########&......&..h#..#..##
##.#######.#.+.#.+.#.....##
##..####@..#&..#.#.#.#...##
##...#########.#.#.#.....##
##....##.+&...v#.#.#....###
##.....#########.#&#...####
##..#..#v..&.....#.#..#####
##.....#.###########.######
##.....#.&.....#..&######
##....##.#####.#.########
##.....#....&#h&...######
##.#...##################
##.............##########
##.......#..#....########
##.........#......#######
##..................#####
##########################