.......................
##..........#..........
####..........#........
#####..................
##################....#
######&......&..h#..#..
.#######.#.+.#.+.#.....
..####@..#&..#.#.#.#...
...#########.#.#.#.....
....##.+&...v#.#.#....#
.....#########.#&#...##
..#..#v..&.....#.#..###
.....#.###########.####
.....#.&.....#..&######
....##.#####.#.########
.....#....&#h&...######
.#...##################
.............##########
.......#..#....########
.........#......#######
..................#####
