###################################################
###################################################
##################################################
#################################################
################################################
###############################################
#########@.................################
#########h.+&+++&++++&++++&#################
#################################################
#################################################
#################################################
###################################################
##################################################
#################################################